20.ox
..........oo......oo
......o..........o..
.......o............
o.......7...........
.................o..
........o...........
.................o..
............o.......
...................o
....................
..o.................
............o.......
..........o.........
...o....o.....o.....
..........o.........
...........o.....o..
.o.......o..o.......
o...................
....................
....o..o............
