100.ox
.....o...o.o..................o.....o.......o......o.o.......o.o..........oo.o..o...o..o.......o....
..o..o...o.............o......o..oo.....o........o..oo..o.................o.o........o..o....o......
.oo...oo......oo..o.........o.....o..o.........o..o.o....oo.............oo...o...o.......o.....oo..o
.........o......o.o..oo.o.o....o........oo.o.......o..........ooo....o...o....o........o..o.o......o
o.o......o...o...oo.o.....oo.o..o...o...ooo...............o..o......o.o..o........ooo..o...o..o.o...
.o......o..o..ooo......o.o.o.........o...........o..o....oo......o....o..o.........o....ooo.o.......
o..o.o...........o.o.o.o...............o.........o.oo.........o.o...o...o...o..oo.........o.o.o..oo.
o.oo...o..........o.....o........o....o.....o.........o..o..........oo..o...o....o..o...oo....o.o..o
.........o.........................o...o.o.....oo.....o.....o....o.o.............oo.o.o.o.oo...o.oo.
oo..o...............................oo....................o....oo................o.....o........o.o.
......oo..o...oo..............o.............o....o.o....o................o..........o..........ooo..
o............o..............o...o.o..o...o...o.oo.......o.............o.........o...........o...o...
.......o....o...o.........o......o...o.o....o..o..o.oo...o.........o......o...o..ooo..o.......o.o..o
...o.oo.....o...oo.......o..o....o.oo.o...oo...o.oo...o.oo..o..o....o.o..o.o..o.o...........oo......
o...o...........ooo...o.o....oo.o.....o.o...o...o....o........oo.....o.o.o...o........oo.o.o..oooo..
..ooo..................o...........oo..o.......o.....o.o......o....o...o..o....o........o.o.o.......
..oo.........o.o.o.......o.......o....o...o....o..........o......o.......oo.ooo......oo......oo.....
.o.........o....ooo...........o........o.o.ooo.....o.....o........o.................o.o.............
o...o..o.o..o....o..o......o...o..o.......o.o.oo..oooo.o....o.oo..o........o............ooo......o..
.....o..........oooo...o...o..oo..oo.oo...o...o.oo.............o........o....o.......o........o.o...
............o.......oo.o...........o....o..................oo..oo.o.o..o...............o..oo.o...o..
.o...o.......o...o........o...........o.oo...oo..o..............o.......o.o......o........o.......o.
o..o........o..o...ooo..oo.o..o.....o......ooo.......o........o.oo.o.o.o.o......oo......o....o..oo..
o.o.ooo..........o.....o.....o.o.....o....o................oo..oo.o..............o......o...........
oo.o...........o...........o........o.o...o..o.....o.....o..........o........o.....o.........o......
o...o....oo..o....o.o...................o.........o.oo..........o....o.......o..o.o...o..o....o..o..
oo.....o...o.o.o.....o.o..o....o.o..............ooo.....o.....o..o....o..o......o.o.....o........oo.
.o...........oo.........oo...o....o.o............o.o....o.....o....o........o.....o.oo.o...o........
....o......o....o...o.....oo....oo....o..o.oooo..o.o..oo......oo........o......o..o..oo...o......o..
....oo......o..oo.o.....o.........o.......o..oo...o..o....o...................o.oo.o...o............
...o..o.........oo.....o.o...o.....o..o.........o......o...o..o.o......oo.....o.......o.....ooo..o..
....o..o...o.o....o...o.....o.........oo.o.o.......ooo........o.....o..o.........o.....oo...o....oo.
.o...o...........o.........oo.....oo..o..........o...o........o.o.........o.....o.o......o..........
........oo...o.....o.......o......o........o.........oo....o..o..o...........o..oo.o.o.o.......o..o.
...o.o....o..o......o.oo..........o...........o.....o............o..o.........o...oo.....o..o.ooo...
.o.o.....o.........o...o......o....o.....o..o............oo.o..o.o...............o...o..o....o..o.o.
...o.......oo.o.o.o.o....o............o......oo.oo.o..o.oo..o.o......o.o.......o..o..o........o.o...
...o.o...o..oo..oo......ooo..............oo..o.o.............o....o............o......oo.o.......o..
.o...o..o..oo..o.o.o...o...o.o....o..o.......o.........o.o............o...o.........oo........o....o
..oo.o....o....o.o......o......o.o.o..o...o...........oo...o.....o..o...........o...o..o....o.o.o...
.......o................o.o..........o......o...o..o.o..........o..o......ooooo...o............o....
oo.......oo......oo..oo......oo..o.o.o.....o...o.....oo.....oo.o........o.o.....oo.....o............
....oo..o.....o...............o.oo.........o.o...oo.....o....o..o..o.o...o...........o.......o.....o
...............o.....o...o....o..o....o..oo..o...o......o...........o...oo.................o.......o
o............o.o.......o.o............o......o.o.....o...........o......oo..o..o....o..o.o.......o..
...........oo........o.o.o....o.o..o..o.......oo.o..o..o.o..o.oo....oo..o..ooooo..o.......o.........
o....o.....o.........o.........oo....o......o.......o...........o.o.....oo...o.......o..o....o...o..
o..o.o...o......oo..o..o.o.....o...........o.....o.ooo.o.....o..................o..o....o......o.oo.
.oo...o....o..o.....o.....oo.oo.o.......oo.o.....o......ooo.o.............o....o..o.......o.o...o...
..........o.....o...o...o...o.o.o...............o..o.o...oo...oo....o......o.o.......o..oo.......o..
......o.o....o..........o..o.o...........o...o..o.............ooo....o.................o....o.......
.....oo......o..o.oo...o.oo.............oo.......oooo.......o...o......o..o...o.o...........o....o..
.....o........o...o..o...................o.....o.......oo.........o..o.o...........ooo.o.o.o........
o.o........ooo.o.o..o......o..o.o...o............o.o...............o.......o......o.o.o........o....
.......oo.oo....o.........o......o.o.....o..o.................o.o....o..o............o...o.o......o.
.........o.o..o..o....oo.o.....o....o.....oo....o.o..o..o...ooo......o....o.o.....o.....o......o....
....o.oooo.o........o............oo...........o...o........o....ooo..o...o..o.ooooo...o.oo...o....o.
oo...o.o......ooo.oo....o....o...o..o..........o...o....o..o....o...................o...............
.....o........o.o.o...o...o....o.....o.....o.......o..........o.....o........o.o...o.............o..
o......o....ooo.........oo..o..oo...o....o....oo.o.o............o...o........o..o.......o.....o.....
...ooo.....o...oo..o...o.o.....o..o..............o........oo..o......o.....o...o.....o......o.......
.o.o.......o....o..........oo....o........o......o....o.....oo.....o.....o...oo...o..o..oo.o.....o..
o.........................o.....o.o...o........oooo...o.....ooo..oo....o..o.o.o..o......o....o....o.
..............o...oo........o.....o...........o...................o..oo.o.o......o......o.......o.o.
o...oo....o....o.o.............oo.......o...o........o........o.o.o....o..oo..o...o.......o.........
.oo.....o.......o......o.oo.o......o...........oooo....o..........oo.........oo...o...oo.o...oo...o.
.......o.o........o.......o.......o..oo......oo......o..oo.o.oo.....o.o...o...o.oo.o.o....o.o.o..o..
..........o.....o....oo.....oo.o...o..oo...oo...o......oo...oo.............oo..o.o.......o..........
.o.o...o...oo.o....o.....o...o................o.oo..o...o........o.....o......o......o...........ooo
..o..o.o.........o.oo.o.......o..o......o..................o...o............o.....o...o.oo....o.oo.o
...o...o..............o..oo...o.......o..o.......oo...o.o.....ooo...o.o.....o.........o.......o.o.o.
.......o....o.o...o...o..........o........o....o.oo..o.......o....o........o....o.o......oo.o..o....
.......oo...o.o..ooo..oo........o.o.oo...o..o.........o............o....................o.......o...
o......o.o...............o.....o...o..o...ooo...oo.........o.o.............o..oooo...o....o..o...o..
...o..o....o.............o.............o...o...o.......o..................o.o...ooo.......o.........
.....o...o.o..o...o..........o.........oo.....o..o.o......o..o..o...............o....o............oo
......o..o....o........o...o..o......o.o.............oo....o.o......o.......o..........o...o........
...oo....o....o..oo..o...o.......o..o......o......oo...o.oo......o.o.ooooo.o.....o.....o...o.....oo.
..o.o.......o....o..o............o..o.o...o.o.o...oo..............o...o.......o....o...o..o..o......
o..o...o....oo.........o....oo...o...o.o.o..oo.ooo..o.o....o..o...o...........oo.o.........o..o..o..
o..o.....o....o..o................o.....o...o.o......o..oo.................o.oo..o...o..............
.....o.o....o..o..o......o..oo.....oo..oo.o...o....o.o.....o.o.............o......o.oo..o.......ooo.
o...................ooo.......o..ooo...................ooo....o.o....o..o........o.o...o............
..oo.....o.o.o.....................o..o....o.o..........ooo....o....oo.o.....o..oo...o..o...........
.....o.oo.............o.o........o....oo....o...................oo.....o....o..o.......o...o.o..o.oo
.o.......oo..o..o...o......oo.o..o..o......o..o.......o.o......o..o.o.oo...o..........o...o.......o.
.......o......o....o..o.o..oo...o..........o.....oo......o.................o....o...o...............
..o.o.o......o.o.......o.........o..o.o...o...........o..o.o..oooo..oo....o.o...........oo.....o.o..
o.....ooo.oo...........o..o.o.........o..o......oo.....o....o.o.o...o......o.oo..o...............o..
o.....o......o.....oooooo..........o..oo.....o....ooo.................o..o.......o.oo..o..o.oo..o.oo
....o..oooo...o.ooo..................o..o..oo..........oo...oooo.o...o...........oo....o.o.........o
o..o......oo.....o........oo...oo......o.....o..o........ooo......oo.o...................oo..o.o....
.......o....o......o....................oo...ooo....o.o.o...o...oo............oo............oo......
.o.....o....o.......o.................o.......o.o.o...oo.....o..o.o..o.o.o.o.o.oo.o..............o..
.........o....o.o...........o..........o.o........o.....o.o.....o.....o.o...........o..o..o.........
.....o.....................o...o.........o....o....o..oooo....o.ooo.............o..oo....oo.oo....o.
.ooo.....ooo........o........o.o.o....o.o....oo.o..............o.....o......oo...o.oo....oo.........
....o..o....o.o..........o......o.....o........o..o.....o..oo..o.....oo...o......o.o..o..o........o.
......o....o....o...oo......o.o..o....o.oo..o..oo........o...o.oo....o.......o.......oo.............
........o.o...............o......o.o....oo..o...............o.......o.....o..o...o.......o.......oo.
